{
    "1": "= A , O",
    "2": "= B , T",
    "3": "= C , T",
    "4": "= D , F",
    "5": "= E , F",
    "6": "= F , S",
    "7": "= G , S",
    "8": "= H , E",
    "9": "= I , N"

}
